1 13 22
######################
#p     ** *  1 * 2 * #
# # # #*# # #*#*# # ##
#  b*     f**        #
# # # #      # # # #*#
#f         x bf  *   #
# # # # # # # # # #*##
#*  *      s  f      #
# # # # #*# # # #*#*##
#*    **  *       *  #
# #*# # # # #        #
#           *   *  * #
######################

